15,15, WIDTH & HEIGHT
W,W,W,W,W,W,W,W,W,W,W,W,W,W,W,
W, , , ,W, , , , , , ,W,W,W,W,
W,W,W, ,W, ,W, , ,W, , ,W, ,W,
W, ,W, ,W, ,W,W,W,W, , ,W, ,W,
W, ,W, ,W, , , , , , ,W,W, ,W, 
W, , , , , ,W, ,W, , , , , ,W,
W,W,W,W,W, ,W, ,W, ,W,W,W,W,W,
W, , , ,W, ,W, ,W, , ,W,G, ,W,
W, ,W,W,W, ,W, ,W,W, ,W,W, ,W,
W, , , , , , , , ,W, ,W,W, ,W,
W, ,W, ,W, ,W, ,W,W, ,W, , ,W,
W, ,W, ,W, ,W, , , , ,W,W, ,W,
W, ,W, ,W,W,W,W,W,W,W,W, , ,W,
W, , , , , , , , , , , , , ,W,
W,W,W,W,W,W,W,W,W,W,W,W,W,W,W,
START,1,1,
