5,5, WIDTH & HEIGHT
W,W,W,W,W,
W, , , ,W,
W, , , ,W,
W, , , ,W,
W,W,W,W,W,
START,1,1,
